abilCode -> AbilId
abilList -> AbilList
aiPlaceType -> AIPlaceType
alphaMode -> AlphaMode
armorSound -> ArmorSound
attackBits -> AttackBits
attackTable -> AtkTable
attackType -> AtkType
attributeType -> AttrType
blendMode -> BlendMode
bool -> Bool
buffCode -> BuffId
char -> Char
combatSound -> CombatSound
combatTarget -> CombatTarget
//controller -> Controller
deathType -> DeathType
defType -> DefType
destructableClass -> DestructableClass
doodadClass -> DoodadClass
effectList -> EffectList
icon -> Icon
int -> Int
intList -> IntList
itemClass -> ItemClass
itemList -> ItemList
lightning -> Lightning
lightningList -> LightningList
model -> Model
modelList -> ModelList
moveType -> MoveType
musicFile -> MusicFile
orderString -> OrderString
pathingPreventList -> PathingPreventList
pathingRequireList -> PathingRequireList
pathingTexture -> PathingTex
playerColor -> PlayerColor
real -> Real
realList -> RealList
regenType -> RegenType
requireList -> ReqList
shadowImage -> ShadowImage
shadowTexture -> ShadowTex
soundLabel -> SoundLabel
spellDetail -> SpellDetail
stringList -> StringList
targetList -> TargetList
teamColor -> TeamColor
techList -> TechList
terrainFogType -> TerrainFogType
texture -> Tex
tileId -> TileId
tileIdList -> TileIdList
tilesetList -> TilesetList
uberSplat -> Ubersplat
unitClass -> UnitClass
unitId -> UnitId
unitList -> UnitList
unitRace -> UnitRace
unitSound -> UnitSound
upgradeClass -> UpgradeClass
upgradeEffect -> UpgradeEffect
upgradeList -> UpgradeList
versionFlags -> VersionFlags
waterCode -> WaterCode
weaponType -> WeaponType